11111
1CE11
10011
11111
1111P
